1111111
1ZPEC11
10Z0001
1000001
100Z001
1000001
1111111
