11111111111
10PC0000001
1Z0Z1111001
10E01110011
11111111111
