111111111111111
10000E000000001
10C00C000C00001
10000000Z000001
100Z000P0C00001
10000C0000C0001
1C0000000C00001
111111111111111
