11111111
10P00E01
10C00C01
11111111
