11111111111111
10000000000001
1P00000ECCCCC1
11111111111111
