111111111111111
10000E000000001
10C00C000C00001
100000000000001
1000000P0C00001
10000C0000C0001
1C0000000C00001
111111111111111
