1111111111111
100000ZPEC001
10Z0000000001
1000000000001
100Z000000001
1000000000001
1111111111111
