11111111111111111111
110111011100001CPEC1
11011101111110100001
11011101111110100001
11000001110000111111
11111101110111111111
11111101110000011111
11111111111111111111
