1111111111111111111111111111
111111CCCCCCCCCCCCCCCCC11111
1PE00000000000000000000CCCC1
1000000000000000000000000001
1CCCC00000000111111111111111
1111111111111111111111111111
1111111111111111111111111111
